10,07,07,07,07,13,07,07,07,07,07,07,07,07,07,07,07,07,07,07,07,13,07,07,07,07,07,07,07,15
11,00,06,00,02,45,00,04,01,02,03,05,00,03,04,00,06,17,28,29,30,45,06,05,04,03,02,01,00,11
11,34,35,36,04,45,02,06,00,01,02,04,01,04,02,01,05,03,31,32,33,45,04,05,06,00,01,02,03,11
11,42,37,38,00,12,07,07,07,07,07,07,07,07,07,07,07,07,07,07,07,14,00,01,02,03,06,05,04,11
11,39,40,41,06,11,02,04,01,00,02,00,06,04,02,06,03,04,02,01,00,45,02,05,01,02,03,02,01,11
11,00,02,05,04,11,01,03,05,01,06,03,01,05,00,01,02,06,05,03,17,45,01,04,00,03,05,06,00,11
11,06,00,01,02,11,00,02,04,10,07,07,07,07,07,07,07,07,07,07,07,14,00,03,06,04,00,03,04,11
12,07,44,44,07,16,44,44,44,14,17,00,01,02,04,05,00,02,04,06,01,26,01,02,04,05,06,01,02,11
11,01,02,03,04,01,05,04,00,11,01,03,04,05,03,06,01,03,05,00,02,23,00,03,00,01,02,00,01,11
11,05,04,05,02,05,02,02,03,11,02,04,06,10,07,07,07,07,07,07,07,14,06,05,06,05,03,02,03,11
12,07,07,07,13,07,07,46,47,14,06,00,01,11,03,01,00,01,02,03,04,11,00,01,03,06,04,00,01,11
11,01,00,06,11,17,02,01,00,11,03,04,05,11,02,34,35,36,28,29,30,11,02,04,02,03,05,04,06,11
11,02,18,05,26,05,06,00,05,11,00,01,02,11,03,42,37,38,31,32,33,11,03,05,00,01,00,01,02,11
11,03,02,01,23,04,05,02,06,11,04,06,05,11,00,39,40,41,00,06,05,11,00,06,03,02,05,04,03,11
11,06,05,04,11,03,04,03,10,08,02,00,06,09,15,01,02,10,07,07,07,08,01,02,03,04,05,06,00,11
11,00,02,03,11,02,01,00,11,03,04,02,01,00,11,03,04,11,02,06,05,00,06,05,28,29,30,01,02,11
12,07,07,44,16,44,07,07,14,01,06,05,06,06,11,05,06,45,03,01,00,01,02,04,31,32,33,03,04,11
11,04,02,03,06,05,00,06,11,00,02,00,04,03,11,02,01,11,04,05,06,03,04,03,02,01,00,06,05,11
11,00,34,35,36,02,01,05,09,07,07,13,07,07,16,07,07,08,00,01,02,10,07,07,07,15,01,02,03,11
11,05,42,37,38,04,05,02,01,03,02,11,00,01,02,03,04,02,05,03,04,11,06,00,01,11,05,00,04,11
11,04,39,40,41,03,17,03,00,04,01,11,01,34,35,36,00,06,00,01,06,11,02,20,03,11,06,01,02,11
11,02,00,17,00,01,06,04,06,05,00,11,02,42,37,38,01,05,02,03,04,11,05,04,06,11,00,03,04,11
11,05,04,03,28,29,30,00,02,03,05,26,03,39,40,41,02,04,05,06,00,11,04,03,02,11,05,06,00,11
11,00,17,02,31,32,33,03,01,04,06,23,04,05,06,00,03,03,03,02,01,11,06,05,03,11,01,02,03,11
11,06,05,02,01,05,04,03,02,01,00,11,04,03,02,01,04,02,04,10,07,14,04,06,04,11,04,05,06,11
11,00,04,03,00,06,03,02,05,05,02,26,05,06,00,01,05,01,05,11,17,11,00,01,02,11,00,03,02,11
11,05,04,06,03,00,04,01,04,04,03,23,06,04,03,02,06,00,06,11,06,09,46,07,47,08,03,06,05,11
11,06,03,00,04,01,05,00,03,00,06,11,05,03,01,06,04,02,00,11,05,03,00,03,01,06,04,02,01,11
11,00,02,01,05,02,06,06,02,01,00,11,17,04,02,00,05,03,01,11,04,02,01,04,02,00,05,03,00,11
09,07,07,07,07,07,07,07,07,07,07,16,07,07,07,07,07,07,07,16,07,07,07,07,07,07,07,07,07,08

0,0,0,0,0,0,0,0,0,0,0,0,0,0,0,0,0,0,0,0,0,1,1,1,1,1,1,1,1,1
0,0,0,0,0,0,0,0,0,0,0,0,0,0,0,0,0,0,0,0,0,1,0,0,0,0,0,0,0,1
0,0,0,0,0,0,0,0,0,0,0,0,0,0,0,0,0,0,0,0,0,1,0,0,0,0,0,0,0,1
0,0,0,0,0,0,0,0,0,0,0,0,0,0,0,0,0,0,0,0,0,1,0,0,0,0,0,0,0,1
0,0,0,0,0,0,0,0,0,0,0,0,0,0,0,0,0,0,0,0,0,1,0,0,0,0,0,0,0,1
0,0,0,0,0,0,0,0,0,0,0,0,0,0,0,0,0,0,0,0,0,1,0,0,0,0,0,0,0,1
0,0,0,0,0,0,0,0,0,1,1,1,1,1,1,1,1,1,1,1,1,1,0,0,0,0,0,0,0,1
1,1,1,1,1,1,1,1,1,1,0,0,0,0,0,0,0,0,0,0,0,0,0,0,0,0,0,0,0,1
1,0,0,0,0,0,0,0,0,1,0,0,0,0,0,0,0,0,0,0,0,0,0,0,0,0,0,0,0,1
1,0,0,0,0,0,0,0,0,1,0,0,0,1,1,1,1,1,1,1,1,1,0,0,0,0,0,0,0,1
1,1,1,1,1,1,1,0,0,1,0,0,0,1,0,0,0,0,0,0,0,1,0,0,0,0,0,0,0,1
1,0,0,0,1,0,0,0,0,1,0,0,0,1,0,0,0,0,0,0,0,1,0,0,0,0,0,0,0,1
1,0,0,0,0,0,0,0,0,1,0,0,0,1,0,0,0,0,0,0,0,1,0,0,0,0,0,0,0,1
1,0,0,0,0,0,0,0,0,1,0,0,0,1,0,0,0,0,0,0,0,1,0,0,0,0,0,0,0,1
1,0,0,0,1,0,0,0,1,1,0,0,0,1,1,0,0,1,1,1,1,1,0,0,0,0,0,0,0,1
1,0,0,0,1,0,0,0,1,0,0,0,0,0,1,0,0,1,0,0,0,0,0,0,0,0,0,0,0,1
1,1,1,1,1,1,1,1,1,0,0,0,0,0,1,0,0,1,0,0,0,0,0,0,0,0,0,0,0,1
1,0,0,0,0,0,0,0,1,0,0,0,0,0,1,0,0,1,0,0,0,0,0,0,0,0,0,0,0,1
1,0,0,0,0,0,0,0,1,1,1,1,1,1,1,1,1,1,0,0,0,1,1,1,1,1,0,0,0,1
1,0,0,0,0,0,0,0,0,0,0,1,0,0,0,0,0,0,0,0,0,1,0,0,0,1,0,0,0,1
1,0,0,0,0,0,0,0,0,0,0,1,0,0,0,0,0,0,0,0,0,1,0,0,0,1,0,0,0,1
1,0,0,0,0,0,0,0,0,0,0,1,0,0,0,0,0,0,0,0,0,1,0,0,0,1,0,0,0,1
1,0,0,0,0,0,0,0,0,0,0,0,0,0,0,0,0,0,0,0,0,1,0,0,0,1,0,0,0,1
1,0,0,0,0,0,0,0,0,0,0,0,0,0,0,0,0,0,0,0,0,1,0,0,0,1,0,0,0,1
1,0,0,0,0,0,0,0,0,0,0,1,0,0,0,0,0,0,0,1,1,1,0,0,0,1,0,0,0,1
1,0,0,0,0,0,0,0,0,0,0,0,0,0,0,0,0,0,0,1,0,1,0,0,0,1,0,0,0,1
1,0,0,0,0,0,0,0,0,0,0,0,0,0,0,0,0,0,0,1,0,1,0,1,0,1,0,0,0,1
1,0,0,0,0,0,0,0,0,0,0,1,0,0,0,0,0,0,0,1,0,0,0,0,0,0,0,0,0,1
1,0,0,0,0,0,0,0,0,0,0,1,0,0,0,0,0,0,0,1,0,0,0,0,0,0,0,0,0,1
1,1,1,1,1,1,1,1,1,1,1,1,1,1,1,1,1,1,1,1,1,1,1,1,1,1,1,1,1,1
